[world]
width = 10
height = 10
map = ##########
      #________#
      #________#
      #________#
      #________#
      #________#
      #________#
      #________#
      #________#
      ##########

[_]
name = floor

[#]
name = wall
blocking = true