______________
______________
__##########__
__#________#__
__#________#__
__#________#__
__#________#__
__#________#__
__#________#__
__#________#__
__#________#__
__##########__
______________
______________