[world]
map = ##########__
      #________#__
      #________#__
      #________#__
      #________#__
      #________#__
      #________#__
      #________#__
      #________#__
      ##########__
      ____________
      ____________

[_]
name = floor

[#]
name = wall
blocking = true