____________________________
____________________________
____________________________
____________________________
____________________________
____________________________
____________________________
____________________________
____________________________
____________________________
____________________________
____________________________
____________________________
____________________________
____________________###_____
____________________#_______
####_____________####_______
___________________##_______
___________________##_______
############################